8 9
3 6
1 1 1 1 1 1 1 1
1 1 1 3 3 1 1 1
1 1 1 0 3 1 1 1
1 1 0 0 2 3 1 1
1 1 0 2 0 0 1 1
1 0 2 0 1 2 0 1
1 0 0 0 0 0 0 1
1 1 1 1 1 1 1 1
1 1 1 1 1 1 1 1